40 40 
23 23 23 23 23 23 23 23 23 23 23 23 23 23 23 23 23 23 23 23 23 23 23 23 23 23 23 23 23 23 23 23 23 23 23 23 23 23 23 23 
26 26 26 26 26 26 26 26 26 26 26 26 26 26 26 26 26 26 26 26 26 26 26 26 26 26 26 26 26 26 26 26 26 26 26 26 26 26 26 26 
0  0  0  0  0  0  0  0  0  0  0  0  0  0  0  0  0  0  0  0  0  0  0  0  0  0  0  0  0  0  0  0  0  0  0  0  0  0  0  0  
23 0  0  0  0  0  0  0  0  0  0  0  0  0  0  0  0  0  0  0  0  0  0  0  0  0  0  0  0  0  0  0  0  0  0  0  0  0  0  23 
23 0  0  0  0  0  0  0  0  0  0  0  0  0  0  0  0  0  0  0  0  1  3  0  0  0  0  0  0  0  0  0  0  0  0  0  0  0  0  23 
23 0  0  0  0  0  0  0  0  0  0  0  0  0  0  19 20 20 21 0  0  4  6  0  0  0  0  0  0  0  0  0  0  0  0  0  0  0  0  23 
23 0  0  0  0  0  0  0  0  0  0  0  0  0  0  22 23 23 24 0  0  4  6  0  0  0  0  19 20 20 21 0  0  0  0  0  0  0  0  23 
23 0  0  0  0  0  0  0  0  0  0  0  0  0  0  22 23 23 24 0  0  4  6  0  0  0  0  22 23 23 24 0  0  0  0  0  0  0  0  23 
23 0  0  0  0  0  0  0  0  0  0  0  0  0  0  22 23 23 24 0  0  4  6  0  0  0  0  22 23 23 24 0  0  0  0  0  0  0  0  23 
23 0  0  0  0  0  0  0  0  0  0  0  0  0  0  25 26 26 27 0  0  4  6  0  0  0  0  22 23 23 24 0  0  0  0  0  0  0  0  23 
0  0  0  0  0  0  0  0  0  0  0  0  0  0  0  0  0  0  0  0  0  4  6  0  0  0  0  22 23 23 24 0  0  0  0  0  0  0  0  0  
0  0  0  0  0  0  0  0  0  0  0  0  0  0  0  10 11 12 0  0  1  5  5  3  0  0  0  22 23 23 24 0  0  0  0  0  0  0  0  0  
2  2  2  2  2  2  2  2  2  2  2  2  2  2  2  13 14 15 1  2  5  5  5  5  2  2  2  2  2  2  2  2  2  2  2  2  2  2  2  2   
8  8  8  8  8  8  8  8  8  8  8  8  8  8  8  16 17 18 7  8  5  5  5  5  8  8  8  8  8  8  8  8  8  8  8  8  8  8  8  8  
0  0  0  0  0  0  0  0  0  0  0  0  0  0  0  0  0  0  0  0  7  5  5  9  0  0  0  22 23 23 24 0  0  0  0  0  0  0  0  0   
0  0  0  0  0  0  0  0  0  0  0  0  0  0  0  0  0  0  0  0  0  4  6  0  0  0  0  22 23 23 24 0  0  0  0  0  0  0  0  0  
0  0  0  0  0  0  0  0  0  0  0  0  0  0  0  0  0  0  0  0  0  4  6  0  0  0  0  22 23 23 24 0  0  0  0  0  0  0  0  0  
0  0  0  0  0  0  0  0  0  0  0  0  0  0  0  0  0  0  0  0  0  4  6  0  0  0  0  22 23 23 24 0  0  0  0  0  0  0  0  0  
0  0  0  0  0  0  0  19 20 20 21 0  0  0  0  0  0  0  0  0  0  4  6  0  0  0  0  25 26 26 27 0  0  0  0  0  0  0  0  0   
0  0  0  0  0  0  0  22 23 23 24 0  0  0  0  0  0  0  0  0  0  4  6  0  0  0  0  0  0  0  0  0  0  0  0  0  0  0  0  0  
0  0  0  0  0  0  0  22 23 23 24 0  0  0  0  0  0  0  0  0  0  4  6  0  0  0  0  0  0  0  0  0  0  0  0  0  0  0  0  0  
0  0  0  0  0  0  0  22 23 23 24 0  0  0  0  0  0  0  0  0  0  4  6  0  0  0  0  0  0  0  0  0  0  0  0  0  0  0  0  0  
0  0  0  0  0  0  0  22 23 23 24 0  0  0  0  0  0  0  0  0  0  4  6  0  0  0  0  0  0  0  0  0  0  0  0  0  0  0  0  0  
0  0  0  0  0  0  0  22 23 23 24 0  0  0  0  0  0  0  0  0  0  4  6  0  0  0  0  0  0  0  0  0  0  0  0  0  0  0  0  0  
0  0  0  0  0  0  0  22 23 23 24 0  0  0  0  0  0  0  0  0  0  4  6  0  0  0  0  0  0  0  0  0  0  0  0  0  0  0  0  0  
0  0  0  0  0  0  0  22 23 23 24 0  0  0  0  0  0  0  0  0  0  4  6  0  0  0  0  0  0  0  0  0  0  0  0  0  0  0  0  0  
0  0  0  0  0  0  0  25 26 26 27 0  0  0  0  0  0  0  0  0  0  4  6  0  0  0  0  0  0  0  0  0  0  0  0  0  0  0  0  0  
0  0  0  0  0  0  0  0  0  0  0  0  0  0  0  0  0  0  0  0  0  4  6  0  0  0  0  0  0  0  0  0  0  0  0  0  0  0  0  0  
0  0  0  0  0  0  0  0  0  0  0  0  0  0  0  0  0  0  0  0  0  4  6  0  0  0  0  0  0  0  0  0  0  0  0  0  0  0  0  0  
0  0  0  0  0  0  0  0  0  0  0  0  0  0  0  0  0  0  0  0  0  4  6  0  0  0  0  0  0  0  0  0  0  0  0  0  0  0  0  0  
0  0  0  0  0  0  0  0  0  0  0  0  0  0  0  0  0  0  0  0  0  7  9  0  0  0  0  0  0  0  0  0  0  0  0  0  0  0  0  0  
0  0  0  0  0  0  0  0  0  0  0  0  0  0  0  10 11 12 0  0  0  0  0  0  0  0  0  0  0  0  0  0  0  0  0  0  0  0  0  0  
0  0  0  0  0  0  0  0  0  0  0  0  0  0  0  13 14 15 0  0  0  0  0  0  0  0  0  0  0  0  0  0  0  0  0  0  0  0  0  0  
0  0  0  0  0  0  0  0  0  0  0  0  0  0  0  13 14 15 0  0  0  0  0  0  0  0  0  0  0  0  0  0  0  0  0  0  0  0  0  0  
0  0  0  0  0  0  0  0  0  0  0  0  0  0  0  13 14 15 0  0  0  0  0  0  0  0  0  0  0  0  0  0  0  0  0  0  0  0  0  0  
0  0  0  0  0  0  0  0  0  0  0  0  0  0  0  13 14 15 0  0  0  0  0  0  0  0  0  0  0  0  0  0  0  0  0  0  0  0  0  0  
0  0  0  0  0  0  0  0  0  0  0  0  0  0  0  16 17 18 0  0  0  0  0  0  0  0  0  0  0  0  0  0  0  0  0  0  0  0  0  0  
0  0  0  0  0  0  0  0  0  0  0  0  0  0  0  0  0  0  0  0  0  0  0  0  0  0  0  0  0  0  0  0  0  0  0  0  0  0  0  0  
0  0  0  0  0  0  0  0  0  0  0  0  0  0  0  0  0  0  0  0  0  0  0  0  0  0  0  0  0  0  0  0  0  0  0  0  0  0  0  0  
0  0  0  0  0  0  0  0  0  0  0  0  0  0  0  0  0  0  0  0  0  0  0  0  0  0  0  0  0  0  0  0  0  0  0  0  0  0  0  0  